NO textures/default/wood.xpm
SO textures/default/wood.xpm
WE textures/default/wood.xpm
EA textures/default/wood.xpm
EA textures/default/wood.xpm

F 220,100,0
C 255,255,255

11111111
 10001
  11E111
 11111
