NO textures/north.xpm
SO textures/south.xpm
WE textures/west.xpm
EA textures/east.xpm

F 220,100,0
C 255,255,255


11111111
 11N0011
  1100111
 111111111
