NO textures/north.xpm
SO textures/south.xpm
WE textures/west.xpm
EA textures/east.xpm

F 220,100,0
C 255,255,255

11111111111111111
10000000000001
10N00000000001

10000000011111111
10000000000000001
10000000000001111
10000000000000001
11111111111111111111111
