11111111111111111
100000000000001
10000000000001
10000000011111111
100000000000000001
10000000000001111
100000000000000001
11111111111111111111111
