11111111111111111
1000000000W0001
10N00000000001
10000000011111111
100000000S00000001
10000000000001111
100000000E00000001
11111111111111111111111
