NO textures/north.xpm
SO textures/south.xpm
WE textures/west.xpm
EA textures/east.xpm

F 220,100,0
C 255,255,255

11111111111 111111
111110N01   10001
10000001    11111
111110101   100001
101
11111111
1111111
1111011
10111111
1111111
