NO textures/default/wood.xpm
SO textures/default/wood.xpm
WE textures/default/wood.xpm
EA textures/default/wood.xpm

F 220,100,0
C 255,255,255

1111NSWE111    111111
111110N01   10001
10000001    11111
111110101    100001
     1
11111111
1111111
111 011
1N111111
1111111
